.......................#
.......................#
.......................#
#......................#
#......................#
#......................#
#......................#
#..........GGG.........#
#..........###.........#
#......................#
#.....GGG........GGG...#
#.....GGG..----..###...#
#.....###..............#
#.....#...............{#
#..1..#..^^^^^^^^^....}#
########################
