#.........=..........+..........#
#.........=..........+..........#
#.........=..........+..........#
#.........=..........+..........#
#.........=..........+..........#
#.........=..........+..........#
#.........=..........+..........#
#.........=..........+..........#
#.........=..........+..........#
#.........=..........+..........#
#.........=..........+..........#
#.........=..........+..........#
#.........=..........+..........#
#.........=..........+........{.#
#...1.....=..........+........}.#
#################################
#################################
#################################
#################################
#################################
#################################