#......................#
#......................#
#......................#
#......................#
#......................#
#......................#
#......................#
#..........GGG.........#
#..........###.........#
#......................#
#.....GGG........GGG...#
#.....GGG........###...#
#.....###..............#
#.....#................#
#..1..#...............X#
########################
