#.........=..........+..........#
#.........=..........+..........#
#.........=..........+..........#
#.........=..........+..........#
#.........=..........+..........#
#.........=..........+..........#
#.........=..........+..........#
#.........=..........+..........#
#.........=..........+..........#
#.........=..........+..........#
#.........=..........+..........#
#.........=..........+........{.#
#.........=....1.....+........}.#
#################################
#################################
#################################
#################################
#################################
#################################
#################################
#################################