#...............................#
#...............................#
#...............................#
#...............................#
#...............................#
#.................{.............#
#.................}.............#
#............[[[[[#.............#
#...............................#
#..............1................#
#............]]]]]].............#
#...............................#
#...............................#
#################################
#################################
#################################
#################################
#################################
#################################
#################################
#################################
