#...............................#
#...............................#
#...............................#
#...............................#
#...............................#
#...............................#
#...............................#
#...............................#
#...............................#
#...............................#
#...............................#
#...............................#
#...............................#
#.............................{.#
#.1..<<<<<.............>>>>>>>}.#
##########.............##########
##########.............##########
##########.............##########
##########.............##########
##########.............##########
##########.............##########