#...............................#
#...............................#
#...............................#
#...............................#
#...............................#
#...............................#
#...............................#
#]]]]]]]##################]]]]]]#
#.......##################......#
#.......##################......#
#[[[[[[[##################[[[[[[#
#.......##################....{.#
#...1...##################....}.#
#################################
#################################
#################################
#################################
#################################
#################################
#################################
#################################
