#..........=......+........=....#
#..........=......+........=....#
#..........=......+........=....#
#..........=......+........=....#
#..........=......+........=....#
#..........=......+........=....#
#..........=......+........=....#
#..........=......+........=....#
#..........=......+........=....#
#..........=......+........=....#
#..........=......+........=....#
#..........=......+........=....#
#..........=......+........=....#
#..........=......+........=..{.#
#.1........=......+........=..}.#
######======+++++++++++++++######
######.....................######
######.....................######
######^^^^^^^^^^^^^^^^^^^^^######
#################################
#################################