#...............................#
#...............................#
#...............................#
#...............................#
#...............................#
#...............................#
#...............................#
#...............................#
#...............................#
#...............................#
#...1.......<<<<<...............#
#################............{..#
#################>>>>>.......}..#
#################################
#################################
#################################
#################################
#################################
#################################
#################################
#################################