#...............................#
#...............................#
#...............................#
#...............................#
#...............................#
#...............................#
#...............................#
#...............................#
#...............................#
#...............................#
#...............................#
#.............................{.#
#.1.....<<<<<.......>>>>>.....}.#
#####...#####.......#####...#####
#####...#####.......#####...#####
#####...#####.......#####...#####
#####...#####.......#####...#####
#####...#####.......#####...#####
#####...#####.......#####...#####
#####...#####.......#####...#####
#####...#####.......#####...#####