#...............................#
#...............................#
#...............................#
#...............................#
#...............................#
#...............................#
#.............................{.#
#==============...............}.#
#..........................######
#..........................######
#+++++++...................######
#..........................######
#..........................######
#....................++++++######
#..........................######
#......========............######
#..........................######
#.1........................######
#######^^^^^^^^^^^^^^^^^^^^######
#################################
#################################