#..............=................#
#..............=................#
#..............=................#
#..............=................#
#..............=................#
#..............=................#
#..............=................#
#..............=................#
#..............=................#
#..............=................#
#..............=................#
#..............=................#
#..............=................#
#..............=..............{.#
#.1..<<<<<.....=.......<<<<<<<}.#
##########.....=.......##########
##########.....=.......##########
##########.....=.......##########
##########.....=.......##########
##########.....=.......##########
##########.....=.......##########