#################################
#################################
#################################
#################################
#################################
######.....+..............#######
######.....+..............#######
######.....+..............#######
######.....+..............#######
######]]]]]#######]]]]]]]]#######
######.....#######........+.....#
######.....#######........+.....#
######[[[[[#######........+.....#
#..........#######........+...{.#
#.1........#######........+...}.#
##################]]]]]]]]#######
##################........#######
##################........#######
##################........#######
##################........#######
##################........#######