#...............................#
#...............................#
#...............................#
#...............................#
#...............................#
#...............................#
#...............................#
#...............................#
#...............................#
#...............................#
#...............................#
#...............................#
#...............................#
#.............................{.#
#.1..<<<<<.............>>>>>>>}.#
##########.............##########
##########.............##########
##########.............##########
##########^^^^^^^^^^^^^##########
#################################
#################################