#################################
#################################
#################################
#################################
#################################
######.....+..............#######
######.....+..............#######
######.....+..............#######
######.....+..............#######
######]]]]]#######========#######
######.....#######........+.....#
######.....#######........+.....#
######[[[[[#######........+.....#
#..........#######........+...{.#
#.1........#######........+...}.#
##################========#######
##################........#######
##################........#######
##################^^^^^^^^#######
#################################
#################################