#..............+..........=.....#
#..............+..........=.....#
#..............+..........=.....#
#..............+..........=.....#
#..............+..........=.....#
#..............+++++++++++#+++++#
#..............+..........=.....#
#.1............+>>>>>>>>>>=.....#
######==========================#
######....................=.....#
######<<<<<<<<<<<<<<<<<<<<=.....#
######+++++++++=]]]]]]]]]]=.....#
######.........=.........+......#
######.........=.........+<<<<<<#
######.........=================#
######.........+..........+...{.#
######.........+<<<<<<<<<<+...}.#
######==========================#
######..........................#
######^^^^^^^^^^^^^^^^^^^^^^^^^^#
#################################