#..........+.........=.....######
#..........+.........=.....######
#..........+.........=.....######
#..........+.........=.....######
#..........+.........=.....######
#..........+>>>>>....+.....######
#]]]]]+++++++++++....++++++######
#.....+.........=..........+..{##
#.....+.........=<<<<<<<<<<+..}##
#[[[[[[[[[[[[[[[======+++++######
#..........=.........=.....######
#<<<<<<<<<<=.........=>>>>>######
#######]]]]]]]]]]]]]]======######
#######.........+..........######
#######>>>>>>>>>+..........######
#######====================######
#..........................######
#.1........................######
#################################
#################################
#################################